哀	喜
愛	憎
悪	善,美,好,良
安	危,高
暗	昭,明
闇	明
易	難
異	同,殊,等
萎	膨
引	押
飲	吐
陰	晴,朗,陽,照
隠	顕,現
現	隠
右	左
雨	晴
影	形
栄	辱,枯
鋭	鈍
益	損,害
円	方,角
怨	恩
遠	近
汚	浄,清
凹	凸
奥	端
往	来,復
応	呼
押	引
横	縦
沖	岸
乙	甲
恩	怨
温	冷,寒,涼
穏	荒
音	訓
下	上,登
仮	真,実
加	減,除
可	否
夏	冬
嫁	婿
寡	多,衆
火	水
禍	慶,福
我	彼
雅	俗
会	別
解	結,縛,縫
海	陸
開	閉
外	内,中
害	利,益
各	共
覚	寝,眠,忘
角	円,方,丸
学	教
楽	憂,苦
活	死,殺
渇	潤
滑	渋,滞
乾	潤,湿
寒	熱,温,暖,暑,涼
完	欠
官	民,軍,私
寛	厳,猛
干	湿,潤
幹	枝,根
歓	苦
甘	辛,苦
緩	急,緊,張,締
閑	忙
丸	角,方
岸	沖
危	安
喜	哀,怒,悲,凶,憂
奇	常,凡
既	未
棄	拾
帰	行
起	滅
偽	実,真
疑	信,決,定
吉	凶
客	主
虐	優
逆	順
久	暫
急	慢,漸,緩
泣	笑
窮	屈
給	需
旧	新
去	来,留
巨	細
虚	実
許	禁
漁	猟
共	各
凶	吉
強	弱
恭	傲
教	学
狭	広
興	衰
暁	暮
曲	直
勤	怠
禁	許
緊	緩
近	遠
苦	歓,甘,辛,楽
愚	賢,明
空	込,塞
屈	伸,窮
掘	埋
君	僕
訓	音
群	独,少,単
軍	民,官
兄	弟
形	影
慶	弔,禍
敬	侮,蔑
継	絶
軽	重
迎	送
欠	満,完,充
決	疑,信
結	解
月	日
健	疲
堅	軟,弱
嫌	好
見	聞
賢	愚
顕	隠,密
厳	寛
減	増,加
言	黙
古	新
呼	応
固	溶
己	他
故	新
枯	栄
後	前,先
悟	迷
公	党,私,官
功	罪
厚	薄
好	悪,疎,嫌
巧	拙
幸	災
広	狭
恒	暫
攻	防
甲	乙
硬	軟
肯	否
荒	和,穏
行	来,帰,戻
降	昇,登,上
香	臭
高	低,安
剛	柔
合	分,剖,離
黒	白,明
込	空
根	枝,末
左	右
差	同,斉
座	立
塞	空
妻	夫
災	幸
細	粗,巨,太
罪	功
昨	明
殺	活,生
雑	純
散	集
暫	久,恒
刺	抜
始	終,末
姉	妹
子	父,母,親
枝	幹,根
止	動,進
死	活,生
氏	名
私	官,公,党
雌	雄
慈	憎
治	乱
自	他
失	得,守
湿	干,燥,乾
疾	徐
質	量
実	虚,偽,仮
捨	取
斜	直
邪	正
正	邪
借	貸
若	老
弱	強
主	客
取	捨
守	奪,失
手	足
殊	異
首	尾
受	送,迎
呪	祝
寿	妖
需	給
収	発
拾	棄
秋	春
終	始,初
臭	香
衆	独,少,寡,単
集	散,配
醜	美
充	欠
柔	剛
渋	滑
縦	横
重	薄,軽
祝	呪
縮	伸
出	入,退
春	秋
潤	渇,干,乾
純	雑
順	逆,倒
初	終,後
暑	寒,涼
助	妨
女	男
徐	疾
除	加,乗
勝	敗,負,劣
将	兵
小	大
少	多,衆,双,群
昇	降
昭	暗
消	燃
照	陰
笑	泣
詳	疎,略
賞	罰
上	下
乗	除
常	奇,特
浄	汚
辱	栄
伸	縮,屈
信	疑,決,定
寝	覚
慎	怠
新	旧,古,故
深	浅
真	偽,仮
親	子
身	殻
殻	身
辛	甘,苦
進	退,止
刃	峰
峰	刃
垂	揚
水	火,湯
衰	興,盛,繁
酔	醒
崇	蔑
是	非
晴	曇,陰,雨
清	汚,濁
生	死,殺
盛	衰
精	粗
西	東
醒	酔
静	乱
斉	差
拙	巧
絶	継
先	後
浅	深
前	後
善	悪
漸	急
疎	好
粗	精
双	独,単
壮	老
早	晩
燥	湿
痩	肥
送	迎,受
騒	静,遜
増	減
憎	愛,慈
足	手,余,腕
速	遅
俗	雅
続	断
存	亡,廃
尊	卑
損	得,益
遜	騒
他	己,自
多	少,寡,独
太	細
怠	勤,励,慎
滞	捗
貸	借
退	進
大	小
濁	清
奪	守,与
脱	着,被
単	複,双,衆,群
旦	夕,暮
淡	濃
短	長
端	奥
断	続
暖	冷,寒,涼
男	女
地	天
恥	誉
稚	老
置	廃
致	廃
遅	速
蓄	費
着	脱
中	外
昼	夜
丁	半
弔	慶
張	緩
朝	夕
長	短
捗	滞
直	曲,斜
沈	浮
珍	凡
追	逃,捕
低	高
定	決,疑,信
弟	兄
締	緩
天	地
貼	剝
吐	飲
登	降,下
怒	喜
倒	順
党	公,私
冬	夏
東	西
湯	水
等	異
答	問
逃	追,捕
頭	尾
騰	落
働	遊
動	止
同	差,異
得	失,損
特	常,凡
毒	薬
独	双,衆,群,多,複
凸	凹
曇	晴
鈍	鋭,敏
内	外
南	北
軟	硬,堅
難	易
肉	霊
日	夜,月
入	出
熱	冷,寒
燃	消
濃	淡
廃	置,致,立
敗	勝
背	腹
配	集
買	売
売	買
剝	貼
白	黒
薄	厚
縛	解
発	収
罰	賞
抜	刺
半	丁
繁	衰
晩	早
卑	尊
否	可,肯
彼	我
悲	喜
疲	健
秘	明
肥	痩
被	脱
費	蓄
非	是
尾	頭,首
美	悪,醜
表	裏
貧	富
敏	鈍
夫	妻
富	貧
浮	沈,没
父	母,子
負	勝
侮	敬
復	来
福	禍
腹	背
複	単,独
分	合
聞	見
兵	将
平	傾
傾	平
閉	開
別	会
蔑	崇,敬
片	両
捕	逃,追
暮	旦,暁
母	父,子
方	円,角,丸
縫	解
亡	存
剖	合
妨	助
忘	覚
忙	閑
膨	萎
防	攻
北	南
僕	君
没	浮,沈
本	末
凡	珍,奇,特
埋	掘
妹	姉
末	本,根,始
慢	急
満	欠
未	既
密	顕,露
民	軍,官
眠	覚
無	有
婿	嫁
名	氏
明	闇,暗,黒,昨,秘
迷	悟
滅	起
猛	寛
黙	言
戻	行
問	答
夜	昼
薬	毒
優	虐,劣
憂	楽,喜
有	無
遊	働
雄	雌
夕	朝,旦
余	足
与	奪
誉	恥
幼	老
妖	寿
揚	垂
溶	固
陽	陰
来	去,往,行
落	騰,拾
乱	治,静
利	害
裏	表
離	合
陸	海
立	廃,座
略	詳
留	去
両	片
涼	暑,寒,暖,温
猟	漁
良	悪
量	質
冷	熱,温,暖
励	怠
霊	肉
劣	優
露	密
朗	鬱
老	稚,壮,若,幼
和	荒
腕	足
傲	恭
鬱	朗
